            R         1920       1080

    NO	asset/tex/grass.xpm           
   SO	asset/tex/grass.xpm           
  EA	  asset/tex/grass.xpm   
     WE	            asset/tex/grass.xpm 
   S          asset/tex/grass.xpm

C   255         ,     255         ,               255              
F   0, 0        ,            0  



















111
1111
100S
1111



