R   1920   1800   345

SO     asset/tex/grass.xpm


NO        asset/tex/grass.xpm


EA      asset/tex/grass.xpm


WE           asset/tex/grass.xpm

S          asset/tex/grass.xpm

F   255, 255, 255
C   255  , 255  ,255

11111111
10200011
10210N11
11111111
