R   1920   1800   

SO     asset/tex/64x64/bricks.xpm                       


NO        asset/tex/64x64/bricks.xpm                


EA      asset/tex/64x64/bricks.xpm                


WE           asset/tex/64x64/bricks.xpm       

S          asset/tex/64x64/bricks.xpm  

F   255, 255, 255, 432
C   255  , 255  ,255

11111111
10200011
10210N11
11111111
