NO	asset/tex/64x64/bricks.xpm
SO	asset/tex/64x64/bricks.xpm
WE	asset/tex/64x64/bricks.xpm
EA   asset/tex/64x64/bricks.xpm
S   asset/tex/64x64/bricks.xpm

C   255, 255, 255

1111111111
1000000001
1111111111
