# Textures

NO	asset/tex/brick.xpm
SO	asset/tex/grass.xpm
EA  asset/tex/metal.xpm
WE  asset/tex/stone.xpm
S	asset/tex/stone.xpm

R	1920  1080

C	255,   255,  255

F	255, 0, 0




                                     11111
                                     S111
11111111111111                       101111
10S000001111111111111111111111111111110111111111111
1100N00000000000110000000000000000000000000000000001
111111111111111111111111111111111111111111111111111
