# Textures

NO	asset/tex/brick.xpm
SO	asset/tex/grass.xpm
EA  asset/tex/metal.xpm
WE  asset/tex/stone.xpm
S	asset/tex/stone.xpm

R	1920  1080

C	255,   255,  255

F	0, 0, 0

111111111
11S000001
1100N0001
111111111
