            R         1920       1980

    NO	asset/tex/grass.xpm
   SO	asset/tex/grass.xpm
  EA	  asset/tex/grass.xpm
     WE	            asset/tex/grass.xpm
   S          asset/tex/grass.xpm

C   255         ,           255         ,               255              
F   0, 0        ,                                                                     0

11111111111111111
1111111111111111111111
1111100000000000000001
11100000000S000000001
 1000000000000111111
1111111000000001
111111111111111
