            R         1080       840

    NO	asset/tex/grass.xpm           
   SO	asset/tex/grass.xpm           
  EA	  asset/tex/grass.xpm   
     WE	            asset/tex/grass.xpm 
   S          asset/tex/grass.xpm

C   255         ,     255         ,               255              
F   0, 0        ,            0  


















11111111111111111
10000000000001111111
100000000000010000001
100000000000010000001
100000N0000111001111
10000000000000001
10000011000000001
10000011000000001
10000000000000001
1111111111111111
