R 1080 640
NO asset/tex/64x64/wolf3d_snow_brick.xpm
EA asset/tex/64x64/wolf3d_mossy_brick.xpm
SO asset/tex/64x64/wolf3d_wood_brick.xpm
WE asset/tex/64x64/wolf3d_snow_brick.xpm
S asset/tex/sprite/wolf3d_guard.xpm

F 220, 220, 220
C 10, 150, 255

111111111111111111111111111111111111111111111111111
100000000000000000000000000000010000000000000000001
100000000000000000000000000000012222222222222222221
100000E00000000000000000000000110000000000000000001
100000000000000000000000000000102222222222222222221
1000000000000000000000000000000000000000000000000001
1000000000000000000000000000001222222222222222222221
1000000000000000000000000000001100000000000000000001
1000000000000000000000000000000122222222222222222221
1000000000000000000000000000000100000000000000000001
1111111111111111111111111111111111111111111111111111
