R   1080 640

NO	asset/tex/64x64/stone_bricks.xpm
SO	asset/tex/64x64/cracked_stone_bricks.xpm
EA	asset/tex/64x64/granite.xpm
WE	asset/tex/64x64/diamond_ore.xpm
S   asset/tex/64x64/nether_sprouts.xpm

C   0,181,226
F   0, 154, 23

1111111111111111111
1000000000000000001
1000000000000000001
1000200000000000001
1000100000000000001
1000000000000000001
10000000N0000000001
1020000000000000001
1000000000000000001
1000000000000000001
1000000020000000001
1000000000000000001
1111111111111111111
