   R        1180 640
        NO           asset/tex/64x64/nether_bricks.xpm
SO       asset/tex/64x64/nether_bricks.xpm
WE asset/tex/64x64/obsidian.xpm
               EA asset/tex/64x64/obsidian.xpm
S    asset/tex/sprite/piglin.xpm
F   220,    128 ,    0
C 225,30,0

            11111111111111111111111111111111111111111111111111111111
111111111111111111111000000000000000000000000000000000000000000111111111111111111111111111111111111
                  111111111111111111111111111111111111111111000000000000000000000000000000000000001
                  111111111111111111111111111111111111111111111111111111111111111111111111110000001
                  111111111111111111100000000000000000000000000000000000000000000000000000000000001
                  10000000000000000000000000000022000000000000000000000000000000000000000000000001 
                  11000000000000000000000000000000000000000000000000000000000000000000000000000001  
                  11100000000000000000000000000000E0000000000000000000000000000000000000000011111  
                  11110000000000000000000000000000000000000000000000000000000000000011111111    
                  11111000000000000000000000000000000000000000000000000000000000000011111111
                  111111000000000000000000000000000000000000000000022222220000000000000000001  
                  11111110000000000000000000000000000000000000000000000000000000000001111111
                  111111110000000000000000000000000000000000000000000000000000000000001
                  11111111100000000000000000000000000000000000000000111111111111111111  
                  11111111110000000000000000000000000000000001111111
                  111111111111111111111111111111111111111111111
