R 1080 800

S asset/tex/sprite/nether_sprouts.xpm
NO asset/tex/16x16/water.xpm
SO asset/tex/16x16/water.xpm
EA asset/tex/16x16/water.xpm
WE asset/tex/16x16/water.xpm

C 0, 50, 255
F 255, 200, 0

11111111111111111111
1000000000S0000000001111111
1002000020000000020000000001
100000000000200000000200020011
100002000000000002000000000200111
1111111111111111111111111111100001
1111111111111111111111111111100001
                            1100111111
                        111112222222221111
                        111111122222221111
                        1111111222222221111
                       1111111111111111
