            R         1920       1080

    NO	asset/tex/grass.xpm
   SO	asset/tex/grass.xpm
  EA	  asset/tex/grass.xpm
     WE	            asset/tex/grass.xpm
   S          asset/tex/grass.xpm

C   255         ,           255         ,               255              
F   0, 0        ,                                                                     0

11111111111111111111111111111111111111111111111111111111111111111111111111111111111111111111111111111111111111111111111111111111111111111111111111111111111111111111111111111111111111111111111111111111111111111111111111111111111111111111111111111111111111111111111111111111111111111111111111111111111111111111111111111111111111111111111111111111111111111111111111111111111111111111111111111111111111111111111111111111111111111111111111111111111111111111111111111111111111111111111111111111111111111111111111111111111111111111111111111111111111111111111111111111111111111111111111111111111111111111111111111111111111111111111111111111111111111111111111111111111111111111111111111111111111111111111111111111111111111111111111111111111111111111111111111111111111111111111111111111111111111111111111111111111111111111111111111111111111111111111111111111111111111111111111111111111111111111111111111111111111111111111111111111111111111111111111111111111111111111111111111111111111111111111111111111111111111111111111111111111111111111111111111111111111111111111111111111111111111111111111111111111111111111111111111111111111111111111111111111111111111111111111111111111111111111111111111111111111111111111111111111111111111111111111111111111111111111111111111111111111111111111111111111111111111111111111111111111111111111111111111111111111111111111111111111111111111111111111111111111111111111111111111111111111111111111111111111111111111111111111111111111111111111111111111111111111111111111111111111111111111111111111111111111111111111111111111111111111111111111111111111
100221000000000000000000000000000000000000000000000000000000000000000000000000000000000000001
10002000000000000000000000000000000000000000000000000000000000000000000000000011111111111111
111111111111111111111111111111111111111111111111111111111111111111111111100N1111
111111111111111111111111111111111111111111111111111111111111111          122111
1111111111111111111111111111111111111111111111111111111111111111111111111111111
