R   1080 640

NO	asset/tex/grass.xpm
SO	asset/tex/grass.xpm
EA	asset/tex/grass.xpm
WE	asset/tex/grass.xpm
S   asset/tex/grass.xpm

C   255,255,255
F   0, 0, 0

11111
1111111111
1111111111111111111111111111111111111111111111111111111111111
10000000000000000000000000000000000000000000000000000000000111111
100000000000000000000000000000000000000000000000000000000001111
10000000000000000000000000000000000000000000000000000000000111
1000000000000000000000000000000000000000000000000000000000011111
1000000000000000000000000000000000000000000000000000000000011
100000000000000000000000000000000000000000000000000000000001
100002000000000000000000000000000000000000000000000000000001
10000000000000000000000000000000000000000000000000000000000111
10000000000000000000000000N0000000000000000000000000000000011
100000000000000000000000000000000000000000000000000000000001
1000020000000000000000000000000000000000200000000000000000011111
100000000000000000000000000000000000000000000000000000000001
1000000000000000000000000000000000000000000000000000000000011
10000000000000000000000000000000000000000000000000000000001111111111111111
111111111111111111111111111111111111011111111111111111111111111111111111111
111111111111111111111111111111111111011111111111111111111111
111111111111111111111111111111111111011121111111111111111111
1111111111111111111111111111111111110111111111111111111111111111
100000000000000000000000000000000000000000000000000000000001
10000000000000000002000000000000000000000000000000011111111
111111111111111111111110000111111111111111111111111111
11111111111111111   1 10000111111                 111111111111111
1111111111111111111111111111111111111111111111111111111
