R         1080       640

NO	asset/tex/64x64/mc-faithul/ice.xpm          
SO	asset/tex/64x64/mc-faithul/stone.xpm           
EA	  asset/tex/64x64/mc-faithul/oak_log.xpm
WE	           asset/tex/64x64/mc-faithul/granite.xpm
S          asset/tex/64x64/mc-faithul/spawner.xpm

C   255         ,     0         ,               255              
F   0, 255        ,            0  












11111111111111111111111111111111111111111111111111111111111111111111111111
1100000000000000000000000000000000000000000000000001111
1111111111100000000000000E00000000000000000000000001
11111111111111000000000000000000000000000000000000011111111111111111111111111111
1111111111111111000011111111111111111111000000000001
                11111111111111111111111111100000000111111111111111111111111111111111
                                         1111111111111





