R         1080       640

NO	asset/tex/grass.xpm           
SO	asset/tex/grass.xpm           
EA	  asset/tex/grass.xpm   
WE	           asset/tex/grass.xpm 
S          asset/tex/grass.xpm

C   255         ,     0         ,               255              
F   0, 255        ,            0  


















1111111111111111111111111111111111111111111111111111111111111111111111111111111111111111111111111111111111111
1000000000001100000000000000000000000000000000000000000000000000000000000000000000000000000000000000000000001
1E00000000000000000000000000000000000000000000000000000000000000000000000000000000000000000000000000000000001
1111111111111111111111111111111111111111111111111111111111111111111111111111111111111110000000000000000000001
                                                                                      10000000000000000000001
                                                                                      10000000000000000000001
                                                                                      10000000000000000000001
                                                                                      100000000000000000000011111111
                                                                                      100000000000000000000000011111
                                                                                      111111111111111111111111111111
