R   1920   1800 

SO     asset/tex/grass.xpm


NO        asset/tex/grass.xpm


EA      asset/tex/grass.xpm hello world eeee world


WE           asset/tex/grass.xpm

S          asset/tex/grass.xpm

F   255, 255, 255
C   255  , 255  ,255

11111111
10200011
10210N11
11111111
