R   1080 640

NO	asset/tex/16x16/brick.xpm
SO	asset/tex/16x16/planks_oak.xpm
EA	asset/tex/16x16/planks_birch.xpm
WE	asset/tex/16x16/planks_spruce.xpm
S   asset/tex/sprite/nether_sprouts.xpm

C   0,181,226
F   0, 154, 23

11                                                                11                   111                                      111 
10111111111111111111111111111111111111111111111111111111111111111111111111111111111111111111111111111111111111111111111111111111111111111111111111         
1000000000000000000E000000000000000000000000000000000000000000000000000000000000000000000000000000000000000000000000000000000000000000000000111111        
11111111111111111111111111111111111111111111111111111111111111111111111111111111111111111111111111111111111111111111101111111111111111111111111111      
11111111111111111111111111111111111111111111111111111111111111111                                                   111
11111111111111111111111111111111111111111111111111111111111111111111111111111111111                               
1111111111111111111111111111111111111111111111  
1                   
111111111                    
11111111111111   
111111111 
1111111
111                  
111 
111111111                  
1111111111 
11111111111111111111111111           
1111111111111111111111 
111111111111111                     
111111111111111                      
