R   1920 1080

NO	asset/fake_texture.xpm
SO	asset/fake_texture.xpm
EA	asset/fake_texture.xpm
WE	asset/fake_texture.xpm
S   asset/fake_texture.xpm

C   255, 255, 255
F   0, 0, 0

1111111111111111111111111111111111111111111111111111111111111
10000000000000000000000000000000000000000000000000000000000111111
100000000000000000000000000000000000000000000000000000000001111
10000000000000000000000000000000000000000000000000000000000111
1000000000000000000000000000000000000000000000000000000000011111
1000000000000000000000000000000000000000000000000000000000011
100000000000000000000000000000000000000000000000000000000001
100000000000000000000000000000000000000000000000000000000001
100000000000000000000000000000000000000000000000000000000001
100000000000000000000000000000000000000000000000000000000001
100000000000000000000000000000000000000000000000000000000001
100000000000000000000000000000000000000000000000000000000001
100000000000000000000000000000000000000000000000000000000001
1000000000000000000000000000000000000000000000000000000000011
100000000000000000000000000000000000000000000000000000000011
111111111111111111111111111111111111111111111111111111111111
111111111111111111111111111111111111111111111111111111111111
111111111111111111111111111111111111111111111111111111111111
111111111111111111111111111111111111111111111111111111111111
100000000000000000000000000000000000000000000000000000000001
10000000000000000000000000000000000000000000000000000000000
11111111111111111111111111111111111111111111111111111111111
