R   1920 1080

NO	asset/tex/64x64/bricks.xpm
EA	asset/tex/64x64/bricks.xpm
WE	asset/tex/64x64/bricks.xpm
S   asset/tex/64x64/bricks.xpm

C   255, 255, 255
F   0, 0, 0


111111111
111N11111
111111111
