R   1920 1080

NO	asset/tex/64x64/bricks.xpm
SO	asset/tex/64x64/bricks.xpm
EA	asset/tex/64x64/bricks.xpm
WE	asset/tex/64x64/bricks.xpm
S   asset/tex/64x64/bricks.xpm

C   255, 255, 255
F   43, 0; 0

11111111111111111111111
10000000000000N00000001
111111111111111111111111111
