R   1920 1080

NO	asset/tex/grass.xpm
SO	asset/tex/grass.xpm
EA	asset/tex/grass.xpm
WE	asset/tex/grass.xpm
S   asset/tex/grass.xpm

C   255, 255, 255
F   0, 0, 0

1111111111111111111111111111111111111111111111111111111111111
10000000000000000000000000000000000000000000000000000000000111111
100000000000000000000000000000000000000000020000000000000001111
10000000000000000000000000020000000000000000000000000000000111
1000000000000000000000000000000000000000000000000000000000011111
1000000000000000000000000000000000000000000000000000000000011
100000000020000000000000000000000000000000000000000000000001
100000000000000000000000000000000000000000000000000000000001
100000000000000000000000000000N00000000000000200000000000001
100000000020000000000000000000000000000000000000000000000001
100000000000000000000000000000000000000000000010000000000001
100000000000000000000000000000002000000000000010200000000001
100000000000000000000000000000000000000000000010000000000001
1000000000000000000000000000000000000000000000111111100000011
100000000000000000000000000000000000000000000000000000000011
111111111111111111111111111111111111111111111111111111111111
111111111111111111111111111111111111111111111111111111111111
111111111111111111111111111111111111111111111111111111111111
111111111111111111111111111111111111111111111111111111111111
100000000000000000000000000000000000000000000000000000000001
10000000000000000000000000000000000000000000000000000000000
11111111111111111111111111111111111111111111111111111111111
