R   1080 640

NO	asset/tex/16x16/brick.xpm
SO	asset/tex/16x16/planks_oak.xpm
EA	asset/tex/16x16/planks_birch.xpm
WE	asset/tex/16x16/planks_spruce.xpm
S   asset/tex/sprite/nether_sprouts.xpm

C   0,181,226
F   0, 154, 23

1112211111111111111
1000000000000000001
1000200000000002001
1000000000000000001
1000100000000000001
1000000000000000001
10000000N0000000001
1000000000000000001
1002000000000002001
1000000000000000001
1000000000000000001
1000000000000000001
1111222111111111111
